10
10
t
2 4

h
20

d
20

s
10
10
10
10
10
10
10
10
10
10
10
10
10
10
10
10
10
10

f
@ . . . . . . . . . 
. . . . . . . . . . 
. . . . . . . . . . 
. # . # * . . . . . 
. # . # * * * * * * 
. # . # # # # * * * 
. # . . . . # * * * 
. # . . . . # # # * 
. # # # # . # 0 # * 
- - - - ^ - + * * * 
